何もなし		0

　コア			1	ここが攻撃されるとHPが減る
　通常ブロック		2	防御力アップ	速度低下
　軽量ブロック		3	防御力小アップ	速度小低下
　強化ブロック		4	防御力大アップ	速度低下
　スラスター		5	高速移動時のスピードアップ　エネルギー消費小増加
　エネルギーバリア	6※	敵の弾を消す	機体の接触は防げないダメージ有　弾を撃てない
　自動攻撃ドローン	7	下記の弾を出せるように
　シールドブロック	8	一定値で破壊されるシールドが出現
　エネルギーパック	9	エネルギー量とエネルギー回復量増加

　　通常ポッド		a	角度を変えられるように
　　高速攻撃ポッド	b	素早い通常弾　				威力高め
　　ミサイルポッド	c	少し下のち突撃
　　自動迎撃ポッド	d	自機に近づく敵を攻撃
　　高威力ポッド	e※	速度の遅い弾				打つときに反動を受ける
　　炸裂ポッド		f	少し間を開けて12発弾を拡散させる
　　貫通ポッド		g	素早く敵を貫通する			攻撃低め
　　チャージポッド	h※	溜め時間で威力とスピードが大きくなる
　　焼夷ポッド		i	少し間を開けて爆発する
　　レーザーポッド	j※	直線上にレーザーを放つ
　　グラビティポッド	k※	少し間を開けて周囲の敵を引き寄せる
　　ホーミングポッド	l	照準に一番近い敵に向かって打つ弾	通常と同じ
　　電磁砲ポッド	m※	素早い弾を打つ当たった敵を少し動けなくする	ダメージ有
　　チェーンポッド	o	当たった敵の近くにいる敵のも攻撃する	連なあるほど攻撃低めに
　ウイルスポッド	p	当たった敵のライフを少しずつ削る	毒みたいなもので10段階
　月光ポッド		q	敵の防御力を無視して打つ		
　流星ポッド		r	攻撃力の低い弾を無数に発射する		一つで5つ発射
　太陽ポッド		s	敵に当たるとエネルギーを少し回復
　リターンポッド	t※	ブーメランの軌道で帰ってくる
　腐食ポッド		u	敵の防御力を少しの間下げる
　連続ポッド		v	同じ敵に連続で当てると攻撃力が上昇	倍率+0.1
　プッシュポッド	w	ダメージ与えた後少し後ろに下げる
　トラップポッド	x※	今いる場所にトラップを仕掛ける		持続ダメージ　10秒
　スターダスト		y※	核弾頭を放ち大爆発を起こさせる		
　スターライト		z※	エネルギーを全て使う		少しの間無敵になる　弾は打てる


※ポッドは攻撃用
※基本的に弾は非貫通
※発射間隔でバランスを調整する
※設置数で発射間隔を短くするか攻撃範囲を増やす
※数字裏の※印は特殊攻撃の目印
※特殊攻撃は1種類のみ装備可能

